được giải thưởng awarded
khoa học viễn tưởng	sci-fi
về đồ chơi	toys
kinh dị	horror
viễn tây	western
chiến tranh	war
tình cảm	romance
ca nhạc	music
hoạt hình	animation
tội phạm	crime
chính kịch	drama
câm	silent
chính luận	drama
cổ trang	biography
giã sử	biography
chính trị	politics
đồ chơi	toys
giáng sinh	Christmas
giả tưởng	fiction
hình sự	thriller
nghệ thuật	art
nhạc kịch	musical
phiêu lưu	adventure
tài liệu	documentary
tư liệu	documentary
hàng không	aviation
kỳ ảo	fantasy
anh hùng	superhero
sử thi	epic
thiếu niên	teens
khiêu dâm	porn
lịch sử	history
cổ tích	mystery	
tâm lý	romance
thần thoại	mystery
thể thao	sport
tiểu sử	biography
thảm họa	disaster
thiếu nhi	children
tình báo	spy
trinh thám	detective
võ hiệp	kung fu
hành động	action
phiêu lưu	adventure
truyền hình	drama
gia đình	family
ảo tưởng	fantasy
đen trắng	film-noir
âm nhạc	music
hài	comedy
tết	tet
ma	ghost
duoc giai thuong awarded
khoa hoc vien tuong	sci-fi
ve do choi	toys
kinh di	horror
vien tay	western
chien tranh	war
tinh cam	romance
ca nhac	music
hoat hinh	animation
toi pham	crime
chinh kich	drama
cam	silent
chinh luan	drama
co trang	biography
gia su	biography
chinh tri	politics
do choi	toys
giang sinh	Christmas
gia tuong	fiction
hinh su	thriller
nghe thuat	art
nhac kich	musical
phieu luu	adventure
tai lieu	documentary
tu lieu	documentary
hang khong	aviation
ky ao	fantasy
anh hung	superhero
su thi	epic
thieu nien	teens
khieu dam	porn
lich su	history
co tich	mystery	
tam ly	romance
than thoai	mystery
the thao	sport
tieu su	biography
tham hoa	disaster
thieu nhi	children
tinh bao	spy
trinh tham	detective
vo hiep	kung fu
hanh dong	action
phieu luu	adventure
truyen hinh	drama
gia dinh	family
ao tuong	fantasy
den trang	film-noir
am nhac	music
hai	comedy
tet	tet
